#Node (Gene/Gene Cplx)	Label (E/NE)	NE and E information on individual genes
amyA	NE	NE
glgA	NE	NE
glgB	NE	NE
malP	NE	NE
malS	NE	NE
malZ	NE	NE
gldA	NE	NE
pdxJ	E	E
yfcF|gstA	NE	NE|NE
alkB	NE	NE
ilvC	E	E
ilvD	E	E
plsC	E	E
kduD	NE	NE
rsmI	E	E
rsmF	NE	NE
rsmB	NE	NE
rsmA	NE	NE
rsmH	NE	NE
rsmC	NE	NE
rsmG	NE	NE
rsmD	NE	NE
rsmJ	NE	NE
rsmE	NE	NE
rsuA	NE	NE
cdsA	E	E
cueO	NE	NE
entA	NE	NE
entB&entD&entF	E	NE&E&NE
entE	NE	NE
entH	NE	NE
hcaB	NE	NE
mhpA	NE	NE
mhpB	NE	NE
yihU	NE	NE
citG	NE	NE
citX	NE	NE
ilvI&ilvH|ilvG_1&ilvM|ilvB&ilvN	NE	NE&NE|NE&NE|NE&NE
aas	NE	NE
pldA	NE	NE
pldB|tesA	NE	NE|NE
pdxA	E	E
dsdA	NE	NE
metC|cysK|cysM|malY|tnaA	NE	E|NE|NE|NE|NE
metC|malY	NE	E|NE
sdaB|tdcB|sdaA|tdcG	NE	NE|NE|NE|NE
tnaA	NE	NE
avtA	NE	NE
ydfG	NE	NE
dxr	E	E
ispD	E	E
dmlA|leuB	NE	NE|E
leuC&leuD	E	E&E
dgoD	NE	NE
dgoK	NE	NE
kdgK	NE	NE
kdgT	NE	NE
uxaA	NE	NE
uxuA	NE	NE
yagE	NE	NE
ilvC|panE	NE	E|NE
panB	E	E
manZ&manY&manX	NE	NE&NE&NE
yniC	NE	NE
yagE|yjhH	NE	NE|NE
yagF|yjhG	NE	NE|NE
fabI	E	E
serA	E	E
eda	NE	NE
edd	NE	NE
ilvE	E	E
leuA	E	E
alaC|alaA|alaB	NE	NE|NE|alaB
argD	NE	NE
arnB	NE	NE
aspC	NE	NE
aspC|tyrB	NE	NE|NE
astC	NE	NE
astC|argD	NE	NE|NE
gltD&gltB	NE	NE&NE
gltD&gltB|gdhA	NE	NE&NE|NE
hisC	E	E
icd	E	E
ilvE|aspC|tyrB	NE	E|NE|NE
kgtP	NE	NE
lhgO	NE	NE
menD	NE	NE
patA	NE	NE
puuE|gabT	NE	NE|NE
rffA	NE	NE
roxA	NE	NE
serC	E	E
sucA	NE	NE
tauD	NE	NE
tyrB	NE	NE
tyrB|ilvE	NE	NE|E
yghU|yfcG	NE	NE|NE
mngA	NE	NE
trmJ	NE	NE
trmL	NE	NE
trmH	NE	NE
ubiG	NE	NE
ubiI	NE	NE
ubiH	NE	NE
ubiX|ubiD	NE	NE|E
dadA	NE	NE
ybdL	NE	NE
metB	E	E
pflB|tdcE	NE	NE|NE
eno	E	E
garK	NE	NE
gpmA	NE	NE
gpmM	NE	NE
phoA	NE	NE
ispE	E	E
ispF	E	E
yhhW	NE	NE
chpB	NE	NE
ygeX	NE	NE
rlmN	NE	NE
rlmM	NE	NE
rlmB	NE	NE
rlmE	NE	NE
rlmI	NE	NE
rlmD	NE	NE
rlmC	NE	NE
rlmF	NE	NE
rlmJ	NE	NE
rlmG	NE	NE
rlmL	NE	NE
rlmA	NE	NE
rlmH	NE	NE
rluD	NE	NE
rluE	NE	NE
rluF	NE	NE
rluB	NE	NE
rluA	NE	NE
rluC	NE	NE
rna	NE	NE
dkgA|dkgB	NE	NE|NE
ghrB	NE	NE
ispG	E	E
acpT|acpS	NE	NE|E
cysH	E	E
cysQ	NE	NE
entD	E	E
ygjK	NE	NE
dcyD	NE	NE
aroD	NE	NE
aroE	E	E
ydiB	NE	NE
aroB	E	E
aroF|aroH|aroG	NE	NE|NE|NE
aroA	E	E
aroC	E	E
fabG	E	E
fabZ	E	E
puuC	NE	NE
ydfG|rutE	NE	NE|NE
nfi	NE	NE
paaF	NE	NE
paaH	NE	NE
mhpT	NE	NE
paaJ	NE	NE
lyxK	NE	NE
yiaK	NE	NE
fadI|fadA	NE	NE|NE
fadJ|fadB	NE	NE|NE
atoE	NE	NE
ydiF|atoA	NE	NE|NE
fabB	E	E
sseA	NE	NE
tag	NE	NE
aidB	NE	NE
ubiA	E	E
fabF	NE	NE
nudL	NE	NE
phoA|aphA|serB	NE	NE|NE|E
hcaC&hcaD&hcaF&hcaE	NE	NE&NE&NE&NE
rtcA	NE	NE
aphA|umpG|cpdB	NE	NE|NE|NE
cpdB	NE	NE
sufS|csdA	NE	NE|NE
nth|nei	NE	NE|NE
paaI	NE	NE
pdxB	E	E
pabB&pabA	E	E&E
pabC	NE	NE
patD	NE	NE
gabP	NE	NE
gadB|gadA	NE	NE|NE
gadC	NE	NE
puuD	NE	NE
mhpD	NE	NE
mhpE	NE	NE
aaeA&aaeB	NE	NE&NE
ubiC	NE	NE
coaA	E	E
dfp	E	E
thrB	E	E
fau	NE	NE
folD	E	E
glyA	E	E
hemB	E	E
hemL	E	E
arnA	NE	NE
idnD	NE	NE
idnO	NE	NE
idnT	NE	NE
nudG	NE	NE
cmoB	NE	NE
garD	NE	NE
garL	NE	NE
gudD	NE	NE
ggt&ggt	NE	NE&NE
metF	E	E
metH	NE	NE
dcm	NE	NE
mtn	NE	NE
speE	NE	NE
purD	E	E
purF	E	E
purL	E	E
purN	NE	NE
purT	NE	NE
endA	NE	NE
recE|polA	NE	NE|E
nfo	NE	NE
ralR	NE	NE
recD&recC&recB	NE	NE&NE&NE
purK	E	E
purM	E	E
thiC	NE	NE
hmp|nfsB	NE	NE|NE
rtcB	NE	NE
rne	E	E
lacA	NE	NE
miaA	NE	NE
miaB	NE	NE
folC	E	E
folP	E	E
queF	NE	NE
tgt	NE	NE
queC	NE	NE
yceF	NE	NE
bioA	E	E
bioF	E	E
chiA	NE	NE
pagP	NE	NE
hycI	NE	NE
betA	NE	NE
caiA	NE	NE
fdhF	NE	NE
glcD&glcE&glcF	NE	NE&NE&NE
hcp	NE	NE
katG	NE	NE
lldD	NE	NE
narY&narZ&narV|narG&narH&narI	NE	NE&NE&NE|NE&NE&NE
queG	NE	NE
rutC	NE	NE
sufS	NE	NE
ubiF	NE	NE
yliI	NE	NE
ynfE&ynfF&ynfG&ynfH	NE	NE&NE&NE&NE
lipB	NE	NE
lplA	NE	NE
acs	NE	NE
actP	NE	NE
aes	NE	NE
aldB	NE	NE
argE	E	E
chbG	NE	NE
citC	NE	NE
citD&citF&citE	NE	NE&NE&NE
cysM|cysK	NE	NE|NE
lpxC	E	E
nagA	NE	NE
pgaB	NE	NE
poxB	NE	NE
purT|ackA	NE	NE|NE
satP	NE	NE
yfdE	NE	NE
ymdB	NE	NE
adhP|adhE	NE	NE|NE
deoC	NE	NE
eutB&eutC	NE	NE&NE
ltaE	NE	NE
mhpF|adhE	NE	NE|NE
queD	NE	NE
fabF|fabB	NE	NE|E
fabH	NE	NE
atoB	NE	NE
yohF	NE	NE
ydjG	NE	NE
yeaE|dkgA|dkgB|yghZ	NE	NE|NE|NE|NE
accA&accD	E	E&E
aceE&aceF	E	NE&E
aceF	E	E
argA	E	E
cysE	E	E
eutD|pta	NE	NE|NE
fadA	NE	NE
glcB|aceB	NE	NE|NE
glmU	E	E
kbl	NE	NE
maa	NE	NE
mnaT	NE	NE
nhoA	NE	NE
phnO	NE	NE
prpC|gltA	NE	NE|E
rffC	NE	NE
rimJ|rimI	NE	NE|NE
rimL	NE	NE
speG	NE	NE
tdcE	NE	NE
tmcA	NE	NE
ydbK	NE	NE
rfe	NE	NE
rffM	NE	NE
argB	E	E
eamB|eamA	NE	NE|NE
acpH	NE	NE
fabD	E	E
lpxA	E	E
lpxD	E	E
lpxL	NE	NE
lpxM	NE	NE
lpxP	NE	NE
plsB	E	E
tesA	NE	NE
yhdH	NE	NE
ttcA|thiI	NE	NE|NE
tesB|yciA	NE	NE|NE
yccX	NE	NE
adeD	NE	NE
adeP	NE	NE
adeQ	NE	NE
amn	NE	NE
apt	NE	NE
deoD	NE	NE
phnL&phnH&phnG&phnI	NE	NE&NE&NE&NE
queA	NE	NE
rihC	NE	NE
lysU	NE	NE
add	NE	NE
nupC	NE	NE
phoA|cpdB|umpG	NE	NE|NE|NE
nudF	NE	NE
bioC	NE	NE
cfa	NE	NE
cheR	NE	NE
cysG	E	E
mnmC	NE	NE
pcm	NE	NE
prmA	NE	NE
prmB	NE	NE
prmC	E	E
rimO	NE	NE
tam	NE	NE
tehB	NE	NE
trmA	NE	NE
trmD	E	E
trmI	NE	NE
trmO	NE	NE
ubiE	NE	NE
yfiC	NE	NE
yhdJ|dam	NE	NE|NE
apaH	NE	NE
entE|lysU	NE	NE|NE
cobC	NE	NE
cobS	NE	NE
btuR	NE	NE
cobU	NE	NE
thiF	NE	NE
thiI|thiF	NE	NE|NE
purA	E	E
purB	E	E
glnE	NE	NE
glgC	NE	NE
rfaD	NE	NE
rfaE	NE	NE
waaC	NE	NE
waaF	NE	NE
waaQ	NE	NE
waaU	E	E
nudE|nudF	NE	NE|NE
accC	E	E
aceK	NE	NE
ackA|tdcD	NE	NE|NE
adk	E	E
alsA&alsC&alsB	NE	NE&NE&NE
alsK	E	E
anmK	NE	NE
araB	E	E
araG&araH&araF	NE	NE&NE&NE
aroK|aroL	NE	NE|NE
artJ&artQ&artM&artP|hisQ&hisP&hisM&argT	NE	NE&NE&NE&NE|NE&NE&NE&NE
atpD&atpB	E	NE&E
bioD	E	E
btuD&btuC&btuF	NE	NE&NE&NE
carB&carA	E	E&E
ccmD&ccmE&ccmC&ccmB&ccmA	NE	NE&NE&NE&NE&NE
cmk	NE	NE
coaE	E	E
copA	NE	NE
cydD&cydC	E	NE&E
cysA&cysW&cysU&cysP|sbp&cysW&cysU&cysA	NE	NE&NE&NE&NE|NE&NE&NE&NE
cysC	E	E
dbpA	NE	NE
ddlB|ddlA	NE	NE|NE
dgkA	NE	NE
dppD&dppF&dppB&dppC&dppA	NE	NE&NE&NE&NE&NE
fecE&fecC&fecD&fecB	NE	NE&NE&NE&NE
fepC&fepD&fepG&fepB	NE	NE&NE&NE&NE
fhuC&fhuB&fhuD	NE	NE&NE&NE
frlD	NE	NE
fruK	NE	NE
fucK	NE	NE
galK	NE	NE
glk	NE	NE
glnA	E	E
glnQ&glnP&glnH	NE	NE&NE&NE
glpK	NE	NE
gltI&gltK&gltJ&gltL	NE	NE&NE&NE&NE
glxK	NE	NE
gmk	E	E
gntK|idnK	NE	NE|NE
gshA	NE	NE
gshB	NE	NE
gsiA&gsiB&gsiD&gsiC	NE	NE&NE&NE&NE
gsk	NE	NE
gss	NE	NE
gyrA&gyrB	E	E&E
hipA	NE	NE
hisP&hisM&hisQ&hisJ	NE	NE&NE&NE&NE
hisQ&hisP&hisM&argT	NE	NE&NE&NE&NE
hscA	NE	NE
hsdM&hsdR&hsdS	NE	NE&NE&NE
kdpF&kdpA&kdpB&kdpC	NE	NE&NE&NE&NE
livF&livG&livH&livM&livJ	NE	NE&NE&NE&NE&NE
livF&livG&livH&livM&livJ|livK&livM&livH&livG&livF	NE	NE&NE&NE&NE&NE|NE&NE&NE&NE&NE
lpxK	E	E
lsrB&lsrD&lsrC&lsrA	NE	NE&NE&NE&NE
lsrK	NE	NE
lysC|metL|thrA	NE	NE|E|E
mak	NE	NE
malK&malF&malG&malE	NE	NE&NE&NE&NE
metN&metI&metQ	NE	NE&NE&NE
mglA&mglC&mglB	NE	NE&NE&NE
mgtA	NE	NE
mgtA|nikD&nikE&nikB&nikC&nikA	NE	NE|NE&NE&NE&NE&NE
modC&modB&modA	NE	NE&NE&NE
mpl	NE	NE
msbA	E	E
murC	E	E
murD	E	E
murE	E	E
murF	E	E
nadK	E	E
nadR	NE	NE
nagK	NE	NE
nanK	NE	NE
ndk	NE	NE
nrdA	E	E
nrdE	NE	NE
oppB&oppC&oppD&oppF&mppA	NE	NE&NE&NE&NE&NE
pck	NE	NE
pdxK	NE	NE
pdxY|pdxK	NE	NE|NE
pfkA	NE	NE
pfkA|pfkB	NE	NE|NE
pfkB	NE	NE
pgk	E	E
phnC&phnE_1&phnD	NE	NE&NE&NE
phnN	NE	NE
pncB	NE	NE
potA&potB&potC&potD	NE	NE&NE&NE&NE
potA&potB&potC&potD|potG&potH&potI&potF	NE	NE&NE&NE&NE|NE&NE&NE&NE
ppk	NE	NE
proB	E	E
proV&proW&proX	NE	NE&NE&NE
pstB&pstA&pstC&pstS	NE	NE&NE&NE&NE
psuK	NE	NE
purC	E	E
puuA	NE	NE
pykF|pykA	NE	NE|NE
pyrG	E	E
pyrH	E	E
ravA	NE	NE
rbsA&rbsC&rbsB	NE	NE&NE&NE
rbsK	NE	NE
recQ|rep|dnaB	NE	NE|NE|E
rhaB	E	E
ribF	E	E
rimK	NE	NE
ssuA&ssuC&ssuB	NE	NE&NE&NE
sucD&sucC	NE	NE&NE
tauA&tauC&tauB	NE	NE&NE&NE
tcdA	NE	NE
tdk	NE	NE
thiD	NE	NE
thiD|pdxK	NE	NE|NE
thiK	NE	NE
thiL	E	E
thiM	NE	NE
thiQ&thiP&tbpA	NE	NE&NE&NE
tmk	E	E
tolC&macB&macA	NE	NE&NE&NE
udk	NE	NE
ugpC&ugpA&ugpE&ugpB	NE	NE&NE&NE&NE
waaP	NE	NE
waaY	NE	NE
wzc|etk	NE	NE|NE
xylB	NE	NE
xylG&xylH&xylF	NE	NE&NE&NE
ybcF	NE	NE
yeaG|rdoA	NE	NE|NE
yegS	NE	NE
yejF&yejB&yejE&yejA|oppC&oppD&oppF&oppB&oppA	NE	NE&NE&NE&NE|NE&NE&NE&NE&NE
yihV	NE	NE
yjeF	NE	NE
yjfF&ytfR&ytfT&ytfQ	NE	NE&NE&NE&NE
yjfF&ytfR&ytfT&ytfQ|mglA&mglC&mglB	NE	NE&NE&NE&NE|NE&NE&NE
zntA	NE	NE
znuC&znuB&znuA	NE	NE&NE&NE
cusC&cusB&cusF&cusA	NE	NE&NE&NE&NE
adiA|speA	NE	NE|NE
adiC	NE	NE
speB	NE	NE
hisH&hisF	E	E&E
purH	E	E
alaS	E	E
ahpC&ahpF	NE	NE&NE
aphA	NE	NE
bcp|tpx	NE	NE|NE
bioH	E	E
nagZ	NE	NE
ugpQ|glpQ	NE	NE|NE
uidA	NE	NE
ybbO|ahr|yahK|yqhD	NE	NE|NE|NE|NE
paoA&paoB&paoC	NE	NE&NE&NE
ssuD	NE	NE
tynA	NE	NE
yqhD	NE	NE
alkA	NE	NE
arfB|pth	NE	NE|E
dtd	NE	NE
rnd	NE	NE
allB	NE	NE
allC	NE	NE
lacZ	E	E
ushA	NE	NE
galM	NE	NE
melA	NE	NE
otsA	NE	NE
pgm	NE	NE
treF|treA	NE	NE|NE
lacY	NE	NE
setB|setA	NE	NE|NE
cobT	NE	NE
iaaA&iaaA|iadA	NE	NE&NE|NE
mtfA|ypdF	NE	NE|NE
pepA	NE	NE
pepB	NE	NE
pepD	NE	NE
pepE	NE	NE
pepP	NE	NE
pepQ	NE	NE
pepT	NE	NE
ypdE	NE	NE
cof|nudJ	NE	NE|NE
thiE	NE	NE
folB	NE	NE
folK	E	E
yiaY|tdh	NE	NE|NE
ribC	E	E
ribE	E	E
yigB|ybjI	NE	NE|NE
gcvP	NE	NE
gcvT	NE	NE
cheB	NE	NE
nrfD&nrfC&nrfB&nrfA	NE	NE&NE&NE&NE
allE	NE	NE
amtB	NE	NE
asnB|asnA	NE	NE|NE
aspA	NE	NE
astB	NE	NE
cdd	NE	NE
codA	NE	NE
dcd	NE	NE
guaA	E	E
guaC	NE	NE
guaD	NE	NE
hemC	E	E
iaaA|ansA|ansB	NE	NE|NE|NE
lpd&gcvH&gcvT	E	E&NE&NE
mnmE	NE	NE
nadE	E	E
nagB	NE	NE
nirD	NE	NE
pdxH	E	E
pncA	NE	NE
pncC	NE	NE
puuB	NE	NE
ribD	E	E
rutD	NE	NE
tadA	E	E
ybaS|yneH.OROR.	NE	NE|yneH.OROR.
argG	E	E
argS	E	E
asnB	NE	NE
asnS	E	E
aspS	E	E
birA	E	E
caiC	NE	NE
cpdA	NE	NE
cysS	E	E
entF	NE	NE
epmA	NE	NE
fadK|fadD	NE	NE|NE
glnS	E	E
gltX	E	E
gluQ	NE	NE
glyS&glyQ	E	E&E
hisS	E	E
hypF	NE	NE
ileS	E	E
leuS	E	E
ligA|ligB	NE	E|NE
ligT	NE	NE
lysS|lysU	NE	NE|NE
menE	NE	NE
metG	E	E
mnmA	NE	NE
moeA	NE	NE
nudC	NE	NE
paaK	NE	NE
panC	E	E
pheS&pheT	E	E&E
ppsA	NE	NE
proS	E	E
prpE|acs	NE	NE|NE
prs	E	E
relA	NE	NE
relA|spoT	NE	NE|E
rnb	NE	NE
selD	NE	NE
serS	E	E
thrS	E	E
tilS	E	E
trpS	E	E
tyrS	E	E
valS	E	E
ycaO	NE	NE
ynjE	NE	NE
azoR	NE	NE
trpD	E	E
trpE&trpD	E	E&E
cysD&cysN	E	E&E
gutQ|kdsD	NE	NE|NE
kdsA	E	E
sixA	NE	NE
argH	E	E
astA	NE	NE
iap	NE	NE
yddG	NE	NE
arsC	NE	NE
pitA	NE	NE
aslA	NE	NE
ulaC&ulaB&ulaA	NE	NE&NE&NE
ansP	NE	NE
cca	E	E
coaD	E	E
cyaA	NE	NE
hisG	E	E
metK	E	E
moeB	NE	NE
mog	NE	NE
nadD	E	E
nrdD	NE	NE
pcnB	NE	NE
cycA	NE	NE
panD	E	E
fruB&fruA	NE	NE&NE
yqaB	NE	NE
bglX	NE	NE
fabA	E	E
dacA|ampC	NE	NE|NE
betB	NE	NE
emrE	NE	NE
ompF|ompC	NE	NE|NE
proP	NE	NE
bioB	E	E
bisC	NE	NE
lpxB	E	E
lpxH	E	E
gstB	NE	NE
ydaM|dgcZ|ycdT|dosC|yeaP	NE	NE|NE|NE|NE|NE
yfgF|yhjH|gmr|dosP|yahA	NE	NE|NE|NE|NE|NE
mraY	E	E
dctA	NE	NE
dcuC|dcuA|dcuB	NE	NE|NE|NE
rffT	NE	NE
wzxE	NE	NE
murG	E	E
ftsW|murJ	NE	E|E
mrcA|mrcB|mtgA|pbpC	NE	NE|NE|NE|NE
cadB	NE	NE
ldcC|cadA	NE	NE|NE
cynS	NE	NE
rutB	NE	NE
argF|argI	NE	NE|NE
pyrB	E	E
pyrC	E	E
aceE	NE	NE
cynT|can	NE	NE|E
dmlA	NE	NE
dxs	E	E
fdoG&fdoH&fdoI|fdnI&fdnH&fdnG	NE	NE&NE&NE|NE&NE&NE
gcl	NE	NE
gnd	NE	NE
hemE	E	E
hemF	NE	NE
hemN	NE	NE
lysA	E	E
maeA	NE	NE
maeB	NE	NE
menA	NE	NE
nadC	E	E
oxc	NE	NE
pheA	E	E
psd	E	E
pyrF	E	E
scpB	NE	NE
sgbH|ulaD	NE	NE|NE
speD	NE	NE
speF|speC	NE	NE|NE
trpC	E	E
tyrA	E	E
clsB|clsA	NE	NE|NE
clsC	NE	NE
caiB	NE	NE
caiT	NE	NE
fieF	NE	NE
zupT	NE	NE
cdh	NE	NE
pgsA	E	E
pssA	E	E
chbA&chbC&chbB|ascF	NE	NE&NE&NE|NE
bcsZ	NE	NE
bcsB&bcsA	E	E&NE
lipA	NE	NE
nrdG	NE	NE
pflA	NE	NE
thiH	NE	NE
phnJ	NE	NE
hemA	E	E
aat	NE	NE
selA	NE	NE
cobB	NE	NE
chbA&chbC&chbB	NE	NE&NE&NE
chiP	NE	NE
hdhA	NE	NE
mdtM	NE	NE
betT	NE	NE
menF|entC	NE	NE|NE
tyrA|pheA	NE	E|E
acnB|acnA	NE	NE|NE
citT	NE	NE
clcA	NE	NE
clcB	NE	NE
mcrB&mcrC	NE	NE&NE
lspA	E	E
sppA	NE	NE
gspO	NE	NE
kdsB	E	E
waaA	E	E
waaZ	NE	NE
rcnA	NE	NE
zupT|corA	NE	NE|NE
dapD	E	E
fadM	NE	NE
menI	NE	NE
metA	E	E
paaY	NE	NE
prpC	NE	NE
pta	NE	NE
sucB	NE	NE
tesB	NE	NE
btuB	E	E
yihO	NE	NE
yihS	NE	NE
fucI	NE	NE
fucU	NE	NE
tqsA	NE	NE
allA	NE	NE
allD	NE	NE
acnB	NE	NE
prpD	NE	NE
bglF|ascF	NE	NE|NE
ascB|bglA|bglB	NE	NE|NE|NE
folM	NE	NE
bglB	NE	NE
mrdA|mrcB|mrcA|ftsI	NE	E|NE|NE|E
thiG	NE	NE
mutT	NE	NE
galE	NE	NE
galT	NE	NE
galU	NE	NE
ugd	NE	NE
waaG	NE	NE
waaJ	NE	NE
waaO	NE	NE
metE	E	E
fcl	NE	NE
curA	NE	NE
rutA	NE	NE
dapA	E	E
dapB	E	E
mhpC	NE	NE
glf	NE	NE
waaB	NE	NE
ilvA|tdcB	NE	E|NE
acrA&acrB	NE	NE&NE
waaH	NE	NE
eptC	NE	NE
eptA	NE	NE
fadB	NE	NE
psuG	NE	NE
cmoA	NE	NE
uxaC	NE	NE
srlD	NE	NE
ybbB	NE	NE
opgE	NE	NE
mutM	NE	NE
ftnA	NE	NE
yihT	NE	NE
rhaA	E	E
ptsG&crr	NE	NE&NE
yjcS	NE	NE
paaE&paaA&paaC&paaB	NE	NE&NE&NE&NE
ulaG	NE	NE
pgl	NE	NE
yieH	NE	NE
cysJ	E	E
fre	NE	NE
yiaO&yiaN&yiaM	NE	NE&NE&NE
melB	NE	NE
bglF	NE	NE
yahK	NE	NE
phoA|cpdB	NE	NE|NE
mmuM	NE	NE
mmuP	NE	NE
idi	NE	NE
ispA	E	E
ispH	E	E
ycjU	NE	NE
argC	E	E
psuT	NE	NE
moaD&moaE	NE	NE&NE
chbF|bglB|ascB	NE	NE|NE|NE
agp	NE	NE
phoA|suhB	NE	NE|E
frmA	NE	NE
yeiG|frmB	NE	NE|NE
luxS	NE	NE
mobA	NE	NE
prpB	NE	NE
paaZ	NE	NE
gph	NE	NE
menB	NE	NE
cynX	NE	NE
yghA|ybbO|dkgA|yahK	NE	NE|NE|NE|NE
dkgB	NE	NE
arsB	NE	NE
glpF	NE	NE
dmsA&dmsB&dmsC	NE	NE&NE&NE
mocA	NE	NE
recJ	NE	NE
uvrB&uvrC&uvrA	NE	NE&NE&NE
mutL&mutS&mutH	NE	NE&NE&NE
astD	NE	NE
mug	NE	NE
hyuA	NE	NE
tig|surA|fkpA|fkpB|ppiC|ppiB|fklB|slyD|ppiA	NE	NE|NE|NE|NE|NE|NE|NE|NE|NE
bisC|msrA	NE	NE|NE
msrB|msrC	NE	NE|NE
arnC	NE	NE
arnT	NE	NE
lpxT	NE	NE
pgpB|ybjG|bacA	NE	NE|NE|NE
menC	NE	NE
menH	NE	NE
glgX	NE	NE
epmB	NE	NE
wbbI	NE	NE
mngB	NE	NE
amiD|ampD	NE	NE|NE
ampG	NE	NE
mepS|ldcA	NE	NE|NE
lgoD	NE	NE
lgoT	NE	NE
waaL	NE	NE
rbsD	NE	NE
rhaM	NE	NE
nanM	NE	NE
nanA	NE	NE
nanC	NE	NE
nanT	NE	NE
malQ	NE	NE
ytfG	NE	NE
ybiS|ycfS|erfK	NE	NE|NE|NE
mepS|mepH|mepM|ampH|mepA|pbpG|dacB	NE	NE|NE|NE|NE|NE|NE|NE
ynhG|ycbB	NE	NE|NE
mepA	NE	NE
arnE&arnF	NE	NE&NE
pgaD&pgaC	NE	NE&NE
pgaA	NE	NE
yicI	NE	NE
hinT	NE	NE
ycjG	NE	NE
tsaB	E	E
purE	E	E
tehA	NE	NE
ugpQ	NE	NE
mpaA	NE	NE
tonB&exbB&exbD&fhuA	NE	NE&NE&NE&NE
rbn	NE	NE
rnb|pnp	NE	NE|NE
rnd|rnt	NE	NE|NE
rnpB&rnpA	E	rnpB&E
rph	NE	NE
paaG	NE	NE
phnP	NE	NE
lsrG	NE	NE
phnM	NE	NE
cirA|fiu	NE	NE|NE
fes	E	E
yqjH	NE	NE
bglA	NE	NE
chbF	NE	NE
yqjG	NE	NE
fsr	NE	NE
fhuE	NE	NE
murP&crr	NE	NE&NE
murQ	NE	NE
murP	NE	NE
abgB&abgA	NE	NE&NE
abgT	NE	NE
nemA	NE	NE
waaS	NE	NE
glgP	NE	NE
norW	NE	NE
yieF	NE	NE
caiD	NE	NE
casA&casB&casC&casD&casE	NE	NE&NE&NE&NE&NE
ndh	NE	NE
ggt	NE	NE
pepN|pepB|pepA|pepD	NE	NE|NE|NE|NE
iscS	E	E
sufS|iscS	NE	NE|E
rihC|rihB|rihA	NE	NE|NE|NE
codB	NE	NE
zwf	E	E
ddpX	NE	NE
ampH|yfeW|dacC|dacD|dacA	NE	NE|NE|NE|NE|NE
dadX|alr	NE	NE|NE
ldcA	NE	NE
rpiB	NE	NE
alsE	NE	NE
lpcA	NE	NE
uxaB	NE	NE
gmhB	NE	NE
hisB	E	E
gudP|garP	NE	NE|NE
dgoT	NE	NE
exuT	NE	NE
murI	E	E
glmM	E	E
glmS	E	E
nagE|manZ&manY&manX	NE	NE|NE&NE&NE
dld	NE	NE
glcA|lldP	NE	NE|NE
hchA	NE	NE
ldhA	NE	NE
yeiG|gloB	NE	NE|NE
uxuB	NE	NE
suhB	E	E
rihB	NE	NE
fucA	NE	NE
fbaA	E	E
talA|talB	NE	NE|NE
tktB|tktA	NE	NE|NE
dsdX	NE	NE
mtlA|gatC&gatB&gatA|srlA&srlB&srlE	NE	NE|NE&NE&NE|NE&NE&NE
dcuB	NE	NE
fumB	NE	NE
xylA	NE	NE
xylE	NE	NE
nth	NE	NE
nudB	NE	NE
phoA|yfbR	NE	NE|NE
nudI	NE	NE
yfaU	NE	NE
yfaW	NE	NE
dgoA	NE	NE
ispB	E	E
ispU	E	E
deoA	NE	NE
deoB	NE	NE
nrdE|nrdA	NE	NE|E
aphA|ushA|yfdR|yfbR	NE	NE|NE|NE|NE
tatD|sbcB	NE	NE|NE
polA|umuC&umuD|polB|dnaE|dinB	NE	E|NE&NE|NE|E|NE
dgt	NE	NE
phoA|umpG	NE	NE|NE
yfbR	NE	NE
pyrD	E	E
preT&preA	NE	NE&NE
lgt	E	E
lnt	E	E
pgpB	NE	NE
eptB	NE	NE
opgB	NE	NE
ribA	E	E
entB	NE	NE
lpd	E	E
folM|folA	NE	NE|E
thyA	E	E
folX	NE	NE
folE	E	E
dhaM&dhaK&dhaL	NE	NE&NE&NE
fbaB|fbaA	NE	NE|E
gatY&gatZ|kbaY&kbaZ	NE	NE&NE|NE&NE
glpA&glpB&glpC	NE	NE&NE&NE
glpD	NE	NE
gpsA	E	E
mgsA	NE	NE
nadA	E	E
rhaD	E	E
tpiA	NE	NE
ribB	E	E
fsaB|fsaA	NE	NE|NE
rdgB	NE	NE
dcp	NE	NE
dtpA|dtpD|dtpC|dtpB	NE	NE|NE|NE|NE
rnr	NE	NE
ada|ogt	NE	NE|NE
phr	NE	NE
mcrA	NE	NE
ruvC&ruvB&ruvA	NE	NE&NE&NE
ung	NE	NE
mutY	NE	NE
rnhB|rnhA	NE	NE|NE
polA|polB|dnaQ	NE	E|NE|NE
xthA	NE	NE
pinE	NE	NE
recG	NE	NE
gapA	E	E
emrD|mdfA|bcr|mdtL|mdtG|mdtM	NE	NE|NE|NE|NE|NE|NE
mdtK	NE	NE
mdtP&mdtO&mdtN|tolC&mdtC&mdtB&mdtA|acrD&acrA|emrK&emrY|acrE&acrF|emrA&emrB|acrA&acrB|tolC&mdtE&mdtF	NE	NE&NE&NE|NE&NE&NE&NE|NE&NE|NE&NE|NE&NE|NE&NE|NE&NE|NE&NE&NE
rffG|rfbB	NE	NE|NE
rffH|rfbA	NE	NE|NE
rfbC	NE	NE
rfbC&rfbD	NE	NE&NE
rfbD	NE	NE
nudI|dut	NE	NE|E
hyfG&hyfI&hyfA&hyfB&hyfC&hyfD&hyfE&hyfF&hyfH	NE	NE&NE&NE&NE&NE&NE&NE&NE&NE
epmC	NE	NE
csgG&csgE&csgF	NE	NE&NE&NE
fumA	NE	NE
entS	NE	NE
epd	NE	NE
ydiO|fadE	NE	NE|NE
dkgA	NE	NE
mdaB	NE	NE
crcB	NE	NE
cyoE	NE	NE
bfr|cueO	NE	NE|NE
hemH	E	E
mntH	NE	NE
yfeX|efeB	NE	NE|NE
zupT|feoB	NE	NE|NE
fecA	NE	NE
tonB&exbB&exbD&fepA	NE	NE&NE&NE&NE
phoA|ybjI|yigB	NE	NE|NE|NE
ssuE	NE	NE
solA	NE	NE
def	E	E
focA	NE	NE
frc	NE	NE
purU	NE	NE
fmt	E	E
phoA|yggF|ybhA|glpX|fbp	NE	NE|NE|NE|NE|NE
manA	NE	NE
mtlD	NE	NE
pgi	NE	NE
uhpT	NE	NE
frlB	NE	NE
frlA	NE	NE
frlC	NE	NE
gntP	NE	NE
dauA	NE	NE
frdA&frdB&frdC&frdD	NE	NE&NE&NE&NE
fumA|fumB|fumC	NE	NE|NE|NE
nadB	E	E
sdhA&sdhB&sdhC&sdhD	NE	NE&NE&NE&NE
gatC&gatB&gatA	NE	NE&NE&NE
gatD	NE	NE
galP	NE	NE
trpA	E	E
gmd	NE	NE
gmm	NE	NE
cpsB	NE	NE
nudK	NE	NE
gpp	NE	NE
spoT	E	E
appA|yjiA|yeiR|hypB|selB|der|hflX|rsgA|argK	NE	NE|NE|NE|NE|NE|E|NE|NE|NE
nudJ	NE	NE
clpA&clpP|clpX&clpP|clpA&clpX&clpP|clpP	NE	NE&NE|NE&NE|NE&NE&NE|NE
glpG	NE	NE
loiP|hflK&hflC&ftsH	NE	NE|NE&NE&E
lon	NE	NE
ompT	NE	NE
prc	NE	NE
ptrA	NE	NE
phoA|yihX|agp	NE	NE|NE|NE
bglF|manZ&manY&manX|ptsG&crr	NE	NE|NE&NE&NE|NE&NE
treC	NE	NE
gcd	NE	NE
malX	NE	NE
mltF|emtA|mltD|mltC|slt|mltA|mltB	NE	NE|NE|NE|NE|NE|NE|NE
glnD	NE	NE
astE	NE	NE
gltP	NE	NE
gltS	NE	NE
putA	NE	NE
gntP|gntT|gntU|idnT	NE	NE|NE|NE|NE
uidB	NE	NE
btuE	NE	NE
gloA	NE	NE
gor	NE	NE
garR	NE	NE
ghrA|ghrB	NE	NE|NE
glxR	NE	NE
yfbT	NE	NE
glpT	NE	NE
yghZ	NE	NE
fucO	NE	NE
aldA	NE	NE
aceA	NE	NE
hpt|gpt	NE	NE|NE
yrfG	NE	NE
moaA	NE	NE
ghxQ|ghxP	NE	NE|NE
xapA|deoD	NE	NE|NE
nepI	NE	NE
ygaP|sseA|pspE|glpE	NE	NE|NE|NE|NE
ppc	E	E
katE	NE	NE
hisD	E	E
phoA|hisB	NE	NE|E
metL|thrA	NE	E|E
rhtA|rhtB	NE	NE|NE
rhtB	NE	NE
cysJ&cysI	E	E&E
glpE	NE	NE
hyaA&hyaB&hyaC|hybA&hybB&hybO&hybC	NE	NE&NE&NE|NE&NE&NE&NE
hycD&hycC&hycF&hycG&hycB&hycE	NE	NE&NE&NE&NE&NE&NE
adeD|katG|katE	NE	NE|NE|NE
hemG	E	E
sodC|sodB|sodA	NE	NE|NE|NE
ompF|ompC|phoE|ompN	NE	NE|NE|NE|NE
hemD	E	E
xdhA&xdhB&xdhC	NE	NE&NE&NE
yjjX	NE	NE
brnQ	NE	NE
guaB	E	E
phoA|yrfG	NE	NE|NE
mtr	NE	NE
trpB	E	E
insI-3|insI-2|insI-1	NE	insI-3|insI-2|insI-1
kch|kup	NE	NE|NE
mdtM|mdfA|chaA|kefC|kefB	NE	NE|NE|NE|NE|NE
trkH|trkG	NE	NE|NE
kdsC	NE	NE
pgpC|pgpB|pgpA	NE	NE|NE|NE
alaE	NE	NE
pepN	NE	NE
ybjE	NE	NE
araA	E	E
araE	NE	NE
ydeA	NE	NE
asd	E	E
dctA|gltP	NE	NE|NE
proC	E	E
fucP	NE	NE
proA	E	E
rhaT	NE	NE
potE	NE	NE
sgbU|ulaE	NE	NE|NE
ulaF|sgbE|araD	NE	NE|NE|E
aphA|phoA	NE	NE|NE
lepB	E	E
leuE	NE	NE
lptD&lptE	E	E&E
lptD&lptE&lptC&lptA	E	E&E&E&E
dapE	E	E
dapF	NE	NE
fadL	NE	NE
ppx	NE	NE
lysP	NE	NE
mdh	NE	NE
mqo	NE	NE
lamB	NE	NE
srlA&srlB&srlE|mtlA|cmtB&cmtA	NE	NE&NE&NE|NE|NE&NE
cpsG	NE	NE
lacY|melB	NE	NE|NE
nuoA&nuoH&nuoJ&nuoK&nuoL&nuoM&nuoN	NE	NE&NE&NE&NE&NE&NE&NE
torC&torA|torZ&torY	NE	NE&NE|NE&NE
map	E	E
scpA	NE	NE
corA	NE	NE
appA	NE	NE
mntP	NE	NE
ompG	NE	NE
rppH	NE	NE
ghoS|rnlA|mqsR	NE	NE|NE|NE
relE|yafQ|higB|yafO	NE	NE|NE|NE|NE
yoeB	NE	NE
nanE	NE	NE
rrrD	NE	NE
mdtM|mdfA|chaA	NE	NE|NE|NE
nhaA	NE	NE
nhaB	NE	NE
panF	NE	NE
putP	NE	NE
sstT	NE	NE
amiA|amiB|amiC|ampD	NE	NE|NE|NE|NE
hmp	NE	NE
kefF|wrbA|yieF	NE	NE|NE|NE
nfsB	NE	NE
feaB	NE	NE
hcr	NE	NE
phoA|	NE	NE|
pntB&pntA	NE	NE&NE
rffD	NE	NE
sad	NE	NE
sthA	NE	NE
dusC|dusB|dusA	NE	NE|NE|NE
fadH	NE	NE
fpr	NE	NE
gabD	NE	NE
murB	E	E
nfsA	NE	NE
qor	NE	NE
trxB	NE	NE
topB|topA	NE	NE|E
xapA	NE	NE
pnuC	NE	NE
napB&napC&napA	NE	NE&NE&NE
narK|narU	NE	NE|NE
narK|nirC	NE	NE|NE
pnp	NE	NE
yibQ	NE	NE
mazG	NE	NE
orn	E	E
tatD|rnt	NE	NE|NE
rpoA&rpoC&rpoB	E	E&E&E
nupG	NE	NE
tsx	NE	NE
rfbX	NE	NE
thrC	E	E
fabZ|fabA	NE	E|E
hyi	NE	NE
prlC	NE	NE
ptrB	NE	NE
pyrE	E	E
msrA	NE	NE
msrB	NE	NE
ttdA	NE	NE
appC&appB|cydA&cydB&cydX	NE	NE&NE|E&NE&NE
cyoD&cyoA&cyoB&cyoC	NE	NE&NE&NE&NE
phoA|ygiF|ppa	NE	NE|NE|E
sbmA	NE	NE
aroP|pheP	NE	NE|NE
murA	E	E
hisI	E	E
hisA	E	E
aphA|umpH|yjjG|umpG|ushA	NE	NE|NE|NE|NE|NE
etp|wzb|pphB|pphA	NE	NE|NE|NE|NE
otsB	NE	NE
phoA|cof|yigL|ybhA	NE	NE|NE|NE|NE
phoA|ppa	NE	NE|E
pitA|pitB	NE	NE|NE
pphB|pphA	NE	NE|NE
udp	NE	NE
yigL|yidA|yfbT|ybiV	NE	NE|NE|NE|NE
yjbB	NE	NE
degQ|degP	NE	NE|NE
tatB&tatC&tatE&tatA	NE	NE&NE&NE&NE
gpt	NE	NE
upp	NE	NE
yhdE	NE	NE
yhdE|nudI	NE	NE|NE
proP|proY	NE	NE|NE
scpC	NE	NE
dsbG|dsbC|dsbA	NE	NE|NE|NE
dsbG|dsbC	NE	NE|NE
aroP|mtr|tnaB	NE	NE|NE|E
cysZ	NE	NE
dtpC|dtpB|dtpA	NE	NE|NE|NE
fieF|zitB	NE	NE|NE
mdtJ&mdtI	NE	NE&NE
plaP|potE|puuP	NE	NE|NE|NE
rhtA|rhtC	NE	NE|NE
rutG|uraA	NE	NE|NE
satP|dctA	NE	NE|NE
shiA	NE	NE
tdcC	NE	NE
tdcC|sdaC	NE	NE|NE
tyrP|aroP	NE	NE|NE
uacT	NE	NE
uacT|xanQ|xanP	NE	NE|NE|NE
xapB	NE	NE
treB&crr	NE	NE&NE
adhE	NE	NE
xseA&xseB	NE	NE&NE
rpiA|rpiB	NE	NE|NE
rpe	NE	NE
rng	NE	NE
rnc	E	E
dnaG	E	E
yhaV	NE	NE
recF&recR&recO	NE	NE&NE&NE
ttdT	NE	NE
elaD	NE	NE
truA	NE	NE
truD	NE	NE
truB	NE	NE
truC	NE	NE
rffE	NE	NE
mscL|mscS|mscK	NE	NE|NE|NE
ygaZ&ygaH	NE	NE&NE
aqpZ	NE	NE
